1111            111111111111111
1001            100000000000001
1001    1111    100000011111111
1111    1001    11111111
        1111