1111
110111111111111
1000000000000001
111111111111111